30 30
$$$$$$$$$$$$$$$$$$$$$$$$$$$$$$$$
$##############################$
$#                            #$
$#                            #$
$#                            #$
$#                            #$
$#                            #$
$#                            #$
$#                            #$
$#                            #$
$#                            #$
$#                            #$
$#                            #$
$#                            #$
$#                            #$
$#                            #$
$#                            #$
$#                            #$
$#                            #$
$#                            #$
$#                            #$
$#                            #$
$#                            #$
$#                            #$
$#                            #$
$#                            #$
$#                            #$
$#                            #$
$#                            #$
$#                            #$
$##############################$
$$$$$$$$$$$$$$$$$$$$$$$$$$$$$$$$