30 30
$$$$$$$$$$$$$$$$$$$$$$$$$$$$$$$$
$##########          ##########$
$#                            #$
$#                            #$
$#                            #$
$#                            #$
$#                            #$
$#                            #$
$#                            #$
$#                            #$
$#                            #$
$                              $
$                              $
$                              $
$                              $
$                              $
$                              $
$                              $
$                              $
$                              $
$                              $
$#                            #$
$#                            #$
$#                            #$
$#                            #$
$#                            #$
$#                            #$
$#                            #$
$#                            #$
$#                            #$
$##########          ##########$
$$$$$$$$$$$$$$$$$$$$$$$$$$$$$$$$